10.ox
.o.....oo.
........o.
......o..o
......o...
.........o
ook.o.o...
..o.......
.......o.o
......o...
..8.......
